11111111111111111111
10000000000001000001
10000000000011111001
10000111111110000001
10000100000010000001
10000100000010000001
10000000100010000001
10000000100010000001
10000000100010000001
10000000100000000001
10000000100000000001
10000000100000000001
11111111111111111001
10000000000000000001
10000000011111111111
10000000010000000001
10000000010000000001
10000000011100000001
10000000000000000001
11111111111111111111
